1111111111111111111111111111111111111111111111111111111111111111111111111111111111111111111111111111
1000000000000000000000000000100000001000001000000000000000000100000101000000100000000000000000000001
10000000000000000000000000011000000010a0a0100000000000000000a100000111000001100000000000000000000001
1000000000000000000000000111000000001000001000000000000000000000000000000111000000000011111000000001
100000000000000000000001110000000000111011100000000000000000010000000000010000000000001a001000000001
10000000000000000000001100000000000000000000000000000000000001000aa000000100000000000010001000000001
1000000000000000000000100000000000000000000000000000000000000100000000111100000000000010001000000001
1000000000000000000001100000000000000000000000000000000000000111111111100000000000000011011000000001
1000000000000000000001000000000000000000000000000000000000000000000001100000000000000000000000000001
1000000000000000000001000000000000000000000000000000000000000000000001100000000000000000000000000001
1000000000000000000001000000000000000000000000000000000000000000000000110000000000000000000000000001
1000000000000000000001000000000000000000000000000000000000000000000000001110000000000000000000000001
100000001a000000000000000000000000000000000000000000000000000000000000000010000000000000000000000001
1000000010000000000000111000000000000000000000000000000000000000000000000000000000000000000000000001
111110001a000000000000001111111111000000000000000000000000000000000000000000000000000000000000000001
1111111111000000000000000000000001100000000000000000000000000000000000000011110000000000000000000001
1111111111110000000000000000000000000000000000000000000000000000000000000000011000000000000000000001
1111111111111000000000000000000001100000000000000000000000000000000000000000001000000000000000000001
1111111111111111100000000000011111000000000000000000000000000000000000000000001000000000000000000001
1111111111111111111000000011110000000000000000000000000000000000000000000000001000000000000000000001
1111111111111111111111111100000000000000000000111111000000000000000000000000001111000000000000000001
1111111111111111111110000000000000000000000001111111100000000000000000000000000011100000000000000001
1111111111111111111111000000000000000000000001111111100000000000000000000000000000110000000000000001
1111111111111111111111110000000000000000000001111111100000000000000000000000000000010000000000000001
1111111111111111111111111000000000000000000001111111100000000000000000000000000000011100000000000001
1111111111111111111111111100000000000000000001111111100000000000000000000000000000000100000000000001
1111111111111111111111111100000000000000000001111111100000000000000000000000000000000011110000000001
1111111111111111111111111100000000000000000000111111000000000000000000000000011111111111111111111111
1111111111111111111111111111000000000000000000000000000000000000000000000000111111111111111111111111
1111111111111111111111111111110000000000000000000000000000000000000000001111111111111111111111111111
1111111111111111111111111111111100000000000000000000000000000000000000001111111111111111111111111111
1111111111111111111111111111111100000000000000000000000000000000000111111111111111111111111111111111
1111111111111111111111111111111100000000000000000000000000000000001111111111111111111111111111111111
1111111111111111111111111111111110000000000000000000000000000000011111111111111111111111111111111111
1111111111111111111111111111111111000000000000000000000000000000011111111111111111111111111111111111
11111111111111111111111111111111100000000b000b000b000b0000000000011111111111111111111111111111111111
1111111111111111111111111111111110000000000000000000000000000000001111111111111111111111111111111111
11111111111111111111111111111111100000000b000b000b000b0000000000000111111111111111111111111111111111
1111111111111111111111111111111111111111111111111111111111111111111111111111111111111111111111111111