1111111111111111111111111111111111111111
1a00000101100010000010110010000000000001
1011010000001011101110011010101001111111
1010010100111000001000100010101111000001
1100010111111110110010000000000000010101
1111000000000010100001001010111111110101
1001111101011100101101011101000000000001
1100000000100000100001100001010101010101
1010110101111101110011001101110100110101
1000110110100000100001000100100101010001
1010000010101101100100010000110101011111
1110110000101000110100100001100101010001
1000011101101110011001110101011101011101
1011000100100011001011000100000101000001
1101110110001000000001011101010100010101
1000000011111111000111010101011000000101
1011110110100001001101000001000101010101
1110100000001011100001011100111001110001
10000011111010001001010001100000000111b1
1111111111111111111111111111111111111111